resume0_plaintext.txt	Member of Technical Staff
resume1_plaintext.txt	Web Application Tech Lead
resume100_plaintext.txt	Team Size
resume101_plaintext.txt	Electrical Engineer                        July
resume102_plaintext.txt	President
resume103_plaintext.txt	Localization-and Geo Specialist
resume104_plaintext.txt	Senior Project Estimator
resume105_plaintext.txt	Consultant
resume107_plaintext.txt	Coordinator
resume108_plaintext.txt	Software Developer
resume109_plaintext.txt	Documentation and Public Information Intern
resume11_plaintext.txt	Employee Fraud Investigator
resume111_plaintext.txt	Operations and Maintenance Specialist
resume113_plaintext.txt	SYSTEM SUPPORT ANALYST
resume115_plaintext.txt	CORPORATE DEVELOPMENT CONSULTANT
resume117_plaintext.txt	MICROSOFT
resume118_plaintext.txt	Adjunct Faculty
resume119_plaintext.txt	Sr. Sales Engineer
resume12_plaintext.txt	2nd Level Assurance Engineer
resume120_plaintext.txt	ItechSoftLLC, Software Engineer /Team Manager
resume121_plaintext.txt	Women's Basketball Coach
resume122_plaintext.txt	Office Administrative Assistant
resume123_plaintext.txt	Lead User Experience Designer
resume124_plaintext.txt	Senior program manager
resume126_plaintext.txt	World Language Teacher
resume127_plaintext.txt	Volunteer Computer Trainer
resume128_plaintext.txt	Developmental Specialist
resume130_plaintext.txt	VP
resume131_plaintext.txt	LEAD NURTURING & EMAIL MARKETING CONSULTANT
resume132_plaintext.txt	Field Service Technician
resume134_plaintext.txt	Junior Research Associate
resume135_plaintext.txt	Monolingual School Psychologist
resume136_plaintext.txt	Business Process Outsourcing | Project Manager
resume137_plaintext.txt	Test Analyst Assurant
resume138_plaintext.txt	Agile Consultant/Senior Project/Programme Manager
resume139_plaintext.txt	Research Associate
resume14_plaintext.txt	Senior Project Estimator
resume140_plaintext.txt	Assistant Guest Services Manager
resume141_plaintext.txt	Software Administrator/Developer
resume142_plaintext.txt	Administrative Assistant
resume143_plaintext.txt	Prepaid Product Provider
resume144_plaintext.txt	Senior Research Associate
resume145_plaintext.txt	Maintenance Function Manager
resume146_plaintext.txt	Consultant, Health & Safety Advisor and Facilitator
resume148_plaintext.txt	Chief Inspector
resume149_plaintext.txt	Litigation Service Supervisor
resume150_plaintext.txt	Field Inspector
resume151_plaintext.txt	Operations Assistant
resume152_plaintext.txt	WELLTEST SUPERVISOR
resume153_plaintext.txt	BUSINESS DEVELOPMENT DIRECTOR  LATIN AMERICA
resume154_plaintext.txt	Sincerely
resume155_plaintext.txt	WRITER/EDITOR
resume156_plaintext.txt	Administrative Assistant
resume157_plaintext.txt	Owner & Business Consultant
resume159_plaintext.txt	Senior Project Manager/Business Analyst Consultant/Operations Manager
resume16_plaintext.txt	Validation Specialist
resume161_plaintext.txt	Senior Sales Consultant
resume162_plaintext.txt	Independent Software Quality Assurance Engineer
resume164_plaintext.txt	Cloud Infrastructure Consultant
resume165_plaintext.txt	Cloud Infrastructure Consultant
resume166_plaintext.txt	Senior Explorationist
resume167_plaintext.txt	Administrative Assistant/Receptionist
resume168_plaintext.txt	INTEGRATED SCHEDULING SPECIALIST
resume169_plaintext.txt	Drafter\Designer
resume17_plaintext.txt	Motability Operations	   London
resume170_plaintext.txt	Owner/Writer
resume171_plaintext.txt	Senior Surveyor
resume172_plaintext.txt	Quality Assurance, SoftwareTester, Trainer
resume173_plaintext.txt	Software QA Engineer
resume174_plaintext.txt	Undergraduate Researcher
resume175_plaintext.txt	Sr. Technical Support Administrator - Mississauga
resume177_plaintext.txt	Web Application Tech Lead
resume178_plaintext.txt	Sr. I/E Designer                 Ref
resume179_plaintext.txt	Project Manager
resume18_plaintext.txt	Principal RF Hardware Engineer
resume180_plaintext.txt	Field Administrator
resume181_plaintext.txt	Member of Technical Staff
resume182_plaintext.txt	Web Developer
resume183_plaintext.txt	Web Developer
resume184_plaintext.txt	Project Manager
resume185_plaintext.txt	Drafter Design
resume186_plaintext.txt	Program Manager
resume187_plaintext.txt	Mechanical Design Engineer
resume189_plaintext.txt	Marketing Manager / Loss Mit Manager / Closing Manager
resume19_plaintext.txt	Senior Project Manager
resume190_plaintext.txt	Consultants/Volunteer Worker/Homemaker
resume191_plaintext.txt	Product Design Manager
resume192_plaintext.txt	Manila
resume193_plaintext.txt	Assistant
resume194_plaintext.txt	President/Owner
resume195_plaintext.txt	Coordinator
resume196_plaintext.txt	Telecommunications Analyst
resume197_plaintext.txt	Security Officer
resume198_plaintext.txt	Senior Director
resume199_plaintext.txt	Regional Senior Clinical Research Associate
resume2_plaintext.txt	Web Design Intern
resume20_plaintext.txt	Member of Technical Staff
resume200_plaintext.txt	PROJECT CONTROLS
resume201_plaintext.txt	Admin Assistant, Journey Manager & Document Controller
resume203_plaintext.txt	Telecommunications Analyst
resume204_plaintext.txt	Manager
resume205_plaintext.txt	Global Security Engineer, Intern
resume206_plaintext.txt	Purchasing/AP Manager
resume207_plaintext.txt	UPS Administrator
resume21_plaintext.txt	Patient Service Assistant
resume210_plaintext.txt	Computer Applications Instructor
resume211_plaintext.txt	Regional Service Administrator
resume212_plaintext.txt	Sr. Unix System Administrator
resume213_plaintext.txt	Home Care Provider
resume215_plaintext.txt	Illustrator/AutoCAD Draughtsman
resume216_plaintext.txt	Call Center Supervisor
resume217_plaintext.txt	SECURITY SUPERVISOR
resume218_plaintext.txt	Security Officer/ Patrol Officer
resume219_plaintext.txt	Food Service manager
resume22_plaintext.txt	technical support representative
resume220_plaintext.txt	Admitting/Registration Clerk
resume221_plaintext.txt	PROVIDE PROGRAM PLANNING AND SUPPORT
resume222_plaintext.txt	Visiting Resident Physician
resume223_plaintext.txt	Technology Consultant III
resume224_plaintext.txt	Writer
resume226_plaintext.txt	SharePoint Consultant
resume227_plaintext.txt	Individual Instruction Lab Instructor
resume228_plaintext.txt	Systems Analyst
resume229_plaintext.txt	Chief Information Officer
resume23_plaintext.txt	Flooring Sales Specialist
resume231_plaintext.txt	Executive Sous Chef
resume232_plaintext.txt	Telephone Technician
resume233_plaintext.txt	Team Lead
resume234_plaintext.txt	Associate
resume235_plaintext.txt	Human Resources Associate
resume237_plaintext.txt	Assistant Manager
resume238_plaintext.txt	Supervisor of Administration
resume239_plaintext.txt	Sales Associate
resume24_plaintext.txt	Preschool coordinator/teacher
resume240_plaintext.txt	Dental Instructor
resume241_plaintext.txt	Security / Concierge / Deputy Fire Safety Director
resume242_plaintext.txt	Concierge / Deputy Fire Safety Director
resume243_plaintext.txt	Specialist
resume244_plaintext.txt	Channel Marketing Manager
resume245_plaintext.txt	Senior Sales Representative
resume246_plaintext.txt	IT Specialist
resume248_plaintext.txt	Security Officer/ Patrol Officer
resume249_plaintext.txt	Process Technician
resume25_plaintext.txt	Senior Medical Physicist, CyberKnife
resume250_plaintext.txt	Product Manager
resume251_plaintext.txt	Cashier
resume252_plaintext.txt	Hardware QA and Automation Software Engineer
resume253_plaintext.txt	Franchisee
resume254_plaintext.txt	Member of Technical Staff
resume255_plaintext.txt	Sales Representative
resume257_plaintext.txt	Food Service Representative
resume258_plaintext.txt	Director
resume259_plaintext.txt	Producer, Director
resume26_plaintext.txt	Sr. Software Engineer
resume260_plaintext.txt	Director
resume261_plaintext.txt	Certified Nursing Assistant/Personal Care Worker
resume262_plaintext.txt	Sales & Operations Assistant
resume263_plaintext.txt	SENIOR CONSULTANT
resume265_plaintext.txt	Network Operations
resume266_plaintext.txt	Logistics Coordinator
resume268_plaintext.txt	Volunteer - Program Manager
resume269_plaintext.txt	Litigation Support Consultant
resume27_plaintext.txt	Lead Software Engineer
resume270_plaintext.txt	Director of Information Technology
resume271_plaintext.txt	Director of Information Technology
resume272_plaintext.txt	Web Designer
resume273_plaintext.txt	CONSULTANT STRESS
resume274_plaintext.txt	GRADUATE RESEARCH ASSISTANT
resume275_plaintext.txt	Protocol Data Manager/CCRP/RHIA
resume276_plaintext.txt	Audio Engineer
resume277_plaintext.txt	Technical Support Engineer / Apple Computer Technician
resume278_plaintext.txt	Business Development Representative
resume279_plaintext.txt	Test Team Lead
resume280_plaintext.txt	Outside Sales Engineer
resume281_plaintext.txt	Business Developer
resume282_plaintext.txt	Commercial Bathwares
resume283_plaintext.txt	Commercial Bathwares
resume284_plaintext.txt	Commercial Bathwares
resume285_plaintext.txt	Facilities Director
resume286_plaintext.txt	Desktop Support /Network Administrator
resume288_plaintext.txt	Consultant
resume289_plaintext.txt	consultant
resume29_plaintext.txt	Founder / Senior Learning and Development Consultant
resume290_plaintext.txt	Fine Artist
resume292_plaintext.txt	Accounts Receivable Customer Service Representative
resume294_plaintext.txt	PC Repair Technician
resume295_plaintext.txt	Medical Records Clerk
resume296_plaintext.txt	Donor Services Officer
resume297_plaintext.txt	Market Researcher
resume298_plaintext.txt	Senior Fraud Analyst Exeutive
resume299_plaintext.txt	Assistant Property Manager
resume3_plaintext.txt	Vice President
resume30_plaintext.txt	Product Manager
resume300_plaintext.txt	Manager
resume301_plaintext.txt	AR Manager/Payroll Specialist
resume302_plaintext.txt	Job Title  Police Officer
resume303_plaintext.txt	Server/Bartender
resume304_plaintext.txt	Branch Manager
resume306_plaintext.txt	Media Technician
resume307_plaintext.txt	Sales and Design Studio Representative
resume308_plaintext.txt	Direct Support Professional & Client Accounting Coordinator
resume309_plaintext.txt	Web Application Tech Lead
resume31_plaintext.txt	Maintenance Supervisor
resume310_plaintext.txt	Project Manager
resume311_plaintext.txt	Billing Specialist /Assistant Office Manager
resume312_plaintext.txt	Product Manager
resume313_plaintext.txt	Mechanical Design Drafter
resume315_plaintext.txt	Training Assistant
resume316_plaintext.txt	Commonwealth ACS Officer
resume317_plaintext.txt	Office of the City Administrator Intern
resume318_plaintext.txt	TEACHING ASSISTANT IN UNDERGRADUATE ANALYTICAL CHEMISTRY
resume319_plaintext.txt	Research Assistant
resume32_plaintext.txt	Treasury Clerk
resume320_plaintext.txt	Office Manager
resume321_plaintext.txt	Technical Lead
resume322_plaintext.txt	Staff Software Engineer
resume323_plaintext.txt	Risk Management Coordinator
resume324_plaintext.txt	Director
resume325_plaintext.txt	Coordinator
resume326_plaintext.txt	Office Services Manager
resume327_plaintext.txt	GRADUATE STUDENT ASSISTANT
resume328_plaintext.txt	MEDICAL ASSISTANT
resume33_plaintext.txt	General Manager
resume330_plaintext.txt	Sr. Sales Executive & Payments Specialist
resume331_plaintext.txt	Controller
resume332_plaintext.txt	Senior Member Sales Consultant
resume333_plaintext.txt	Consultant
resume334_plaintext.txt	Associate
resume335_plaintext.txt	Director
resume337_plaintext.txt	Designation
resume338_plaintext.txt	Registered Nurse (RN)
resume339_plaintext.txt	QA Consultant
resume34_plaintext.txt	Web Design Intern
resume340_plaintext.txt	Manager
resume341_plaintext.txt	Chief
resume342_plaintext.txt	Volunteer Engineering Intern
resume344_plaintext.txt	Environmental Specialist
resume345_plaintext.txt	Client Service Manager
resume346_plaintext.txt	Senior Member of the IEEE
resume347_plaintext.txt	Graphic/Web Designer
resume348_plaintext.txt	Administrator
resume349_plaintext.txt	Owner and Operator
resume35_plaintext.txt	Director
resume351_plaintext.txt	Director
resume352_plaintext.txt	Consultant
resume353_plaintext.txt	Regional Director of Admissions
resume354_plaintext.txt	Senior Web Marketing Manager
resume355_plaintext.txt	Research Assistant
resume356_plaintext.txt	Multi-Threaded Web Server
resume357_plaintext.txt	Content Editor
resume358_plaintext.txt	Technical Security Analyst
resume36_plaintext.txt	Lead User Experience Designer
resume360_plaintext.txt	Service Technician
resume361_plaintext.txt	Call Center Customer Service Rep
resume362_plaintext.txt	Assistant Manager
resume363_plaintext.txt	Registered Nurse (RN)
resume364_plaintext.txt	Project Manager
resume365_plaintext.txt	Technical Writer
resume366_plaintext.txt	Team Leader
resume367_plaintext.txt	Human Resources Assistant II
resume368_plaintext.txt	Line Chef
resume369_plaintext.txt	Software Engineer
resume37_plaintext.txt	Senior Designer
resume370_plaintext.txt	Fundraising Event Coordinator
resume371_plaintext.txt	Patient Account Specialist, CPAR
resume372_plaintext.txt	ROCKWELL AUTOMATION                                Intern Research Assistant
resume373_plaintext.txt	Senior Electronics Engineer
resume374_plaintext.txt	Graduate Assistant MBA Program / Research Associate
resume376_plaintext.txt	Director of Catering
resume377_plaintext.txt	Director
resume378_plaintext.txt	Graphic Designer
resume379_plaintext.txt	Dental Assistant Instructor
resume38_plaintext.txt	Director of Business Development
resume380_plaintext.txt	Senior System Administrator Desktop Support Analyst
resume382_plaintext.txt	Senior Financial Analyst
resume383_plaintext.txt	PROCUREMENT MANAGER
resume384_plaintext.txt	Customer Relations Manager
resume385_plaintext.txt	Operational Director
resume386_plaintext.txt	V.I.P.S. Member
resume387_plaintext.txt	Server Manager
resume388_plaintext.txt	SR. IS/BUSINESS APPLICATIONS ANALYST
resume389_plaintext.txt	Manager
resume39_plaintext.txt	Bank Teller
resume390_plaintext.txt	Project Manager
resume391_plaintext.txt	TECHNICAL PROJECT MANAGER
resume392_plaintext.txt	Production Assistant
resume393_plaintext.txt	Landauer  Metropolitan
resume396_plaintext.txt	Solutions Architect Manager
resume397_plaintext.txt	Biological Science Technician
resume399_plaintext.txt	Staff Accountant
resume4_plaintext.txt	Staff Software Engineer
resume40_plaintext.txt	Telecom/Electrical Technician
resume400_plaintext.txt	Sales Associate
resume401_plaintext.txt	Arabic Instructor
resume402_plaintext.txt	Construction Manager

Project Secretary
resume403_plaintext.txt	Cashier/Clerk
resume404_plaintext.txt	Founder/ Project Manager
resume405_plaintext.txt	System Analyst
resume406_plaintext.txt	Customer Service Representative
resume407_plaintext.txt	Business Risk Manager
resume408_plaintext.txt	Child Care Provider
resume409_plaintext.txt	Principal Engineer
resume41_plaintext.txt	Product Marketing Engineer
Signetics, Quality Engineer and ASIC Product Engineer
resume410_plaintext.txt	Overnight youth specialist
resume411_plaintext.txt	Arabic Instructor
resume412_plaintext.txt	Business Analyst/Financial Manager
resume413_plaintext.txt	Business Analyst/Financial Manager
resume414_plaintext.txt	Artist
resume415_plaintext.txt	Manager Technical Support & 
Business Analyst
resume417_plaintext.txt	Subsea Design Engineer
resume418_plaintext.txt	INTELLIGENCE ANALYST
resume419_plaintext.txt	Marketing and Design President / Consultant
resume42_plaintext.txt	Computer Refresh Technician
resume420_plaintext.txt	Director of Finance
resume421_plaintext.txt	SENIOR BUSINESS ANALYST
resume422_plaintext.txt	Creative Consultant & Smoke Artist
resume423_plaintext.txt	Office Assistant
resume424_plaintext.txt	IT Technician
resume425_plaintext.txt	Stand-in Project Manager/Project Engineer
resume426_plaintext.txt	BLISS DAY SPA
resume427_plaintext.txt	Associate Engineer
resume428_plaintext.txt	Systems Administrator\Project Lead - Contractor
resume429_plaintext.txt	Director of Creative Innovation
resume43_plaintext.txt	Research Associate
resume430_plaintext.txt	Managing Member - Principal Advisor
resume431_plaintext.txt	Associate Infrastructure Engineer
resume432_plaintext.txt	Legal Assistant
resume433_plaintext.txt	SENIOR BUSINESS OBJECTS CONSULTANT/ DATA ANALYST
resume434_plaintext.txt	Assistant Manager / Music Manager / Backroom Manager
resume435_plaintext.txt	Rehab Reimbursement Assistant
resume436_plaintext.txt	Clearwire , RF/WiMAX Field Technician
resume437_plaintext.txt	Production Analyst
resume438_plaintext.txt	Sales Associate/Cashier/Receptionist
Assistant Manager
resume439_plaintext.txt	CEO AND PRESIDENT
resume44_plaintext.txt	Staff MRI/CT Technologist
resume442_plaintext.txt	Contractor
resume443_plaintext.txt	Account Manager II /Design Specialist
resume445_plaintext.txt	Senior Graphic Designer/Team Leader/Graphic Designer
resume446_plaintext.txt	PC Support Network Specialist
resume447_plaintext.txt	Driver Manager
resume449_plaintext.txt	IT Operations Manager
resume45_plaintext.txt	Executive Assistant
resume450_plaintext.txt	Shorn	Consultant
resume451_plaintext.txt	Executive Assistant
resume452_plaintext.txt	Cashier, Server, and Trainer
resume453_plaintext.txt	Research Assistant
resume454_plaintext.txt	Graphic Designer
resume455_plaintext.txt	Artist
		Graphic Designer
resume457_plaintext.txt	Senior Project Manager/SharePoint Consultant
resume458_plaintext.txt	Service Line Leader
resume46_plaintext.txt	IT Professional
resume460_plaintext.txt	PROJECT 1	

PROJECT	TRIUMPH
resume462_plaintext.txt	Team Leader / Quality Control Trainer Technician
resume463_plaintext.txt	Purchasing Agent
resume464_plaintext.txt	Web Developer
resume465_plaintext.txt	Creative Director / Senior Art Director
resume466_plaintext.txt	President/Founder & Executive Coach
resume467_plaintext.txt	Associate Director
resume468_plaintext.txt	SAP Systems Analyst
resume469_plaintext.txt	Store Team Lead
resume47_plaintext.txt	Quality Executive
resume470_plaintext.txt	Account Manager
resume471_plaintext.txt	Director of Telecommunications
resume472_plaintext.txt	Sales Consultant
resume473_plaintext.txt	Legal Instrument Examiner
resume474_plaintext.txt	Installation Supervisor
resume475_plaintext.txt	Project Coordinator
resume476_plaintext.txt	Biometrics System Administrator & Lead, Field Engineer II & III
resume477_plaintext.txt	Admission Specialist/Work-Studies Supervisor
resume478_plaintext.txt	Stock Investor/Options Trader
resume479_plaintext.txt	Chief Marketing Strategist/Consultant
resume48_plaintext.txt	CATIA V5 Engineering Graphics Designer / Document Control Specialist
resume480_plaintext.txt	Contractor
resume481_plaintext.txt	Owner
resume482_plaintext.txt	Database Associate
resume483_plaintext.txt	Graduate Research Associate
resume485_plaintext.txt	Research Assistant
resume486_plaintext.txt	Technician
resume487_plaintext.txt	Finance Manager
resume488_plaintext.txt	Fraud Recovery Investigator
resume489_plaintext.txt	Administrative and Personal Assistant
resume49_plaintext.txt	Manager
resume490_plaintext.txt	Managing Partner
resume491_plaintext.txt	Technology Consultant
resume492_plaintext.txt	Western Regional Manager
resume494_plaintext.txt	Vice President
resume495_plaintext.txt	Research Assistant
resume496_plaintext.txt	Marketing Coordinator
resume497_plaintext.txt	Sales Consultant/Sales Engineer
resume498_plaintext.txt	Systems Analyst/Technical Consultant
resume499_plaintext.txt	Customer Service Representative
resume5_plaintext.txt	Product Manager
resume50_plaintext.txt	Senior V P
resume500_plaintext.txt	Owner / Senior Designer
resume501_plaintext.txt	Project Coordinator/Manager
resume502_plaintext.txt	IT Support  Manager
resume503_plaintext.txt	Secretary
resume504_plaintext.txt	Research and Development Coordinator
resume505_plaintext.txt	Accountant
resume506_plaintext.txt	Airport Services Representative
resume508_plaintext.txt	Administrative Assistant
resume509_plaintext.txt	Authorization Clerk and Billing Specialist
resume510_plaintext.txt	Senior Graphic Designer
resume511_plaintext.txt	Consultant/Program Manager
resume513_plaintext.txt	Owner
resume514_plaintext.txt	LAB MONITOR / LAB ASSISTANT
resume515_plaintext.txt	Contractor
resume516_plaintext.txt	Member of Technical Staff
resume517_plaintext.txt	Information Systems Specialist
resume518_plaintext.txt	Human Resource Accounting Project/Associate
resume519_plaintext.txt	Research Assistant
resume52_plaintext.txt	Research Faculty
resume520_plaintext.txt	Founder and Chief Executive Officer
resume521_plaintext.txt	IT Project Manager
resume522_plaintext.txt	PET/CT Nuclear Medicine Technologist
resume523_plaintext.txt	Research/Teaching Assistant
resume525_plaintext.txt	Home Health Aide
resume527_plaintext.txt	Founder, President
resume528_plaintext.txt	Co-founder / Sales Director / Project Manager
resume529_plaintext.txt	Founder, President
resume53_plaintext.txt	Systems Analyst
resume530_plaintext.txt	Web Developer
resume531_plaintext.txt	Senior Project Manager
resume532_plaintext.txt	Founder/Business Analyst Consultant
resume535_plaintext.txt	Software Engineer
resume536_plaintext.txt	PAYROLL TECHNICIAN
resume537_plaintext.txt	Accounting Clerk/Contractor
resume538_plaintext.txt	GLOBAL
resume539_plaintext.txt	Administrator
resume54_plaintext.txt	Sales Associate
resume540_plaintext.txt	Senior AML/BSA Compliance Examiner
resume541_plaintext.txt	Business Analyst
resume542_plaintext.txt	AJC Project 			          
Network Technician
resume543_plaintext.txt	Sales Support Administrator
resume544_plaintext.txt	Cosmetology Licensing Processor
resume545_plaintext.txt	Business Process Outsourcing | Project Manager
resume546_plaintext.txt	Illustrator/Production Artist
resume547_plaintext.txt	Buyer
resume548_plaintext.txt	Senior Software Development Engineer
resume55_plaintext.txt	Business Analyst
resume550_plaintext.txt	MRI Technologist
resume551_plaintext.txt	Customer Service and Sales Specialist
resume552_plaintext.txt	Senior Project Manager
resume553_plaintext.txt	Personal Banker III
resume554_plaintext.txt	Systems Manager
resume555_plaintext.txt	Sr. Solutions Architect
resume556_plaintext.txt	Contractor
Programmer Analyst
resume557_plaintext.txt	Systems Analyst Intern
resume558_plaintext.txt	Private Piano and Flute Instructor
resume562_plaintext.txt	Project Manager
resume563_plaintext.txt	Owner/Operator
resume564_plaintext.txt	Software Test Engineer
resume565_plaintext.txt	Sales Associate
resume566_plaintext.txt	Staff Nurse
resume567_plaintext.txt	Monitoring tools and automation engineer
resume568_plaintext.txt	Development Coordinator
resume569_plaintext.txt	Laboratory Processor
resume57_plaintext.txt	Program Director
resume571_plaintext.txt	Construction Scheduling
resume572_plaintext.txt	Tax Examiner
resume573_plaintext.txt	Electro-Mechanical Technician
resume574_plaintext.txt	Corporate Controller/Senior Property Accountant
resume576_plaintext.txt	Computer Technician/ Field Technician/ Help Desk Analyst
resume577_plaintext.txt	Marketing  Coordinator
resume578_plaintext.txt	Software Developer
resume579_plaintext.txt	J2EE designer/developer
resume58_plaintext.txt	Administrator
resume581_plaintext.txt	Director of Business Development
resume582_plaintext.txt	Senior EMR Analyst
resume583_plaintext.txt	IT Service Executive
resume585_plaintext.txt	Project Administrator
resume586_plaintext.txt	Sr. Middleware Administrator
resume587_plaintext.txt	Museum attendant
resume588_plaintext.txt	Senior Software Engineer
resume589_plaintext.txt	Marriage Family Therapist Intern
resume59_plaintext.txt	Engineer
resume590_plaintext.txt	Owner /Founder
resume591_plaintext.txt	NORTHWEST
resume592_plaintext.txt	Director
resume593_plaintext.txt	Owner & CEO
resume594_plaintext.txt	Instructor Pilot
resume595_plaintext.txt	Paid Private Spanish Tutor
resume596_plaintext.txt	Patent Attorney
resume597_plaintext.txt	Business Sales Executive
resume598_plaintext.txt	Assistant Manager
resume599_plaintext.txt	Marketing Programs Manager
resume6_plaintext.txt	Product Manager
resume60_plaintext.txt	Role
Developer / Consultant
resume600_plaintext.txt	Food Service Representative
resume601_plaintext.txt	contractor
resume602_plaintext.txt	Transaction Coordinator /Licensed Real Estate Consultant
resume603_plaintext.txt	Transaction Coordinator /Licensed Real Estate Consultant
resume604_plaintext.txt	Director of Marketing
resume605_plaintext.txt	Visiting IT Trainer
resume607_plaintext.txt	Senior Software Engineer
resume608_plaintext.txt	Independent Marketing Consultant
resume609_plaintext.txt	Management Consultant
resume61_plaintext.txt	Software Support Analyst
resume610_plaintext.txt	Legal Affairs Coordinator
resume611_plaintext.txt	Assistant Manager
resume612_plaintext.txt	Research Assistant
resume614_plaintext.txt	Account Executive
resume615_plaintext.txt	Bookkeeper
resume616_plaintext.txt	Global Privacy & Risk Manager
resume617_plaintext.txt	Desktop Support Technician
resume618_plaintext.txt	HVAC Service Engineer
resume62_plaintext.txt	Software Support Analyst
resume620_plaintext.txt	Participant Service Representative
resume621_plaintext.txt	Customer Service Engineer
resume623_plaintext.txt	Consultant/Program Manager
resume624_plaintext.txt	Intern
resume625_plaintext.txt	CREATIVE DESIGN and CONSULTANT
resume626_plaintext.txt	Owner
resume628_plaintext.txt	Customer Service Representative
resume629_plaintext.txt	Contractor
resume63_plaintext.txt	Honors and Exhibitions
resume630_plaintext.txt	Service Manager
resume631_plaintext.txt	consultant
resume632_plaintext.txt	Real Estate Consultant
resume633_plaintext.txt	Information Technology Specialist
resume634_plaintext.txt	Substitute teacher
resume635_plaintext.txt	Sales and Business Development Manager
resume636_plaintext.txt	Video Production Engineer
resume637_plaintext.txt	Area Sales Manager / Business Development Manager
resume638_plaintext.txt	Senior Associate
resume639_plaintext.txt	Quality Assurance Specialist
resume64_plaintext.txt	Mechanical Engineer
resume640_plaintext.txt	Supplier Relations Manager
resume642_plaintext.txt	Day Laborer
resume643_plaintext.txt	Human Resources Office Assistant
resume644_plaintext.txt	Lead Database Administrator
resume645_plaintext.txt	Communications Specialist
DaVita
resume646_plaintext.txt	Senior Account Director
resume647_plaintext.txt	Paralegal
resume648_plaintext.txt	Administrative assistant
resume649_plaintext.txt	Business Owner
resume65_plaintext.txt	Quality Executive
resume650_plaintext.txt	Executive Assistant
resume651_plaintext.txt	Research aide
resume652_plaintext.txt	Medical Receptionist
resume654_plaintext.txt	Promotion Coordinator/Producer
resume655_plaintext.txt	Staff Development Manager
resume656_plaintext.txt	Vocational /Adult Education Teacher
resume657_plaintext.txt	Sr. Program Management Analyst/Sr. Business Analyst
resume658_plaintext.txt	Front Desk Supervisor/Manager
resume659_plaintext.txt	CAD Drafter
resume66_plaintext.txt	Tool and Process Designer
resume660_plaintext.txt	Principal Engineer
resume661_plaintext.txt	Boyd Media  /  Atlanta                                                                                            Consultant
resume662_plaintext.txt	Software Engineer
resume663_plaintext.txt	Sales Consultant
resume664_plaintext.txt	Afghanistan GIS Analyst
resume665_plaintext.txt	Software Developer
resume666_plaintext.txt	District Contracts Administrator
resume67_plaintext.txt	Community Manager
resume671_plaintext.txt	Project Engineer
resume672_plaintext.txt	Director
resume673_plaintext.txt	Wipro Technology	Project Engineer
resume674_plaintext.txt	Senior network engineer
resume677_plaintext.txt	Dermatopathology Administative Assistant/Manager
resume678_plaintext.txt	Mechanical / Quality Engineer
resume679_plaintext.txt	Senior Production Analyst
resume68_plaintext.txt	Customer Care Representative
resume680_plaintext.txt	Media Director
resume681_plaintext.txt	Senior QA  Analyst
resume682_plaintext.txt	Embedded Software Engineer II
resume683_plaintext.txt	Information Assurance Security Specialist
resume684_plaintext.txt	Assistant Controller
resume685_plaintext.txt	Technical Support and Network Engineer
resume686_plaintext.txt	Senior Product Manager
resume688_plaintext.txt	Security Guard
resume689_plaintext.txt	Office Manager/Customer Service Manager
resume69_plaintext.txt	Web and Content Designer/volunteer
resume690_plaintext.txt	Senior Analyst
resume691_plaintext.txt	Manufacturing Engineering Supervisor
resume692_plaintext.txt	BUSINESS SYSTEMS ANALYST
resume693_plaintext.txt	Contractor
resume694_plaintext.txt	Quality Assurance Analytical Chemist
resume695_plaintext.txt	Manufacturing Engineer
resume697_plaintext.txt	Product Marketing Manager
resume698_plaintext.txt	District Manager
resume699_plaintext.txt	Manager
resume7_plaintext.txt	SimplyHired, Jr. Engineer
resume70_plaintext.txt	Software Developer - III
resume700_plaintext.txt	Working Artist Enterprises
resume701_plaintext.txt	Senior Telecommunications Engineer
resume702_plaintext.txt	Business System Analyst
resume703_plaintext.txt	Production Support Specialist/Developer
resume704_plaintext.txt	FINANCIAL CONSULTANT
resume705_plaintext.txt	Benny Card Analyst
resume706_plaintext.txt	Distribution Sales Director, Energy Analyst
resume707_plaintext.txt	Audio Visual Technician Assistant
resume708_plaintext.txt	jitsu Instructor
resume709_plaintext.txt	Public Relations Consultant
resume71_plaintext.txt	Research / Teaching Assistant
resume710_plaintext.txt	Faculty Appointments    Assistant Professor
resume711_plaintext.txt	contractor
resume713_plaintext.txt	Accountant Assistant
resume714_plaintext.txt	Managing Editor & Publisher
resume715_plaintext.txt	Executive Administrative Assistant/Assistant Controller
resume716_plaintext.txt	Trade Marketing and Territory Sales Manger
resume717_plaintext.txt	Software Developer
resume718_plaintext.txt	Director
resume719_plaintext.txt	Staff Collector, DOT Breath Alcohol/ Urine Drug Testing Technician
resume72_plaintext.txt	Optimization Associate Engineer
resume720_plaintext.txt	Director
resume721_plaintext.txt	Application Architect / Senior Consultant
resume722_plaintext.txt	DIRECTOR OF INFORMATION TECHNOLOGY AND LOGISTICS
resume723_plaintext.txt	CISCO SYSTEMS                  Consultant Software Engineer
resume724_plaintext.txt	Area Representative
resume725_plaintext.txt	Administrative Assistant
resume726_plaintext.txt	Retail Marketing Project Manager
resume727_plaintext.txt	Contracts Specialist
resume728_plaintext.txt	Midco Connections							  Receptionist and Clerical Assistant
resume730_plaintext.txt	VIRTUAL REALITY UPHOLSTERY- OWNER/ OPERATOR
resume731_plaintext.txt	Service Sales Account Specialist
resume732_plaintext.txt	Exec. Financial Accountant
resume733_plaintext.txt	Operations Manager
resume734_plaintext.txt	Sales and Marketing Coordinator
resume735_plaintext.txt	LOGISTICS COORDINATOR
resume736_plaintext.txt	Intern
resume737_plaintext.txt	SALES REPRESENTATIVE AND COMPUTER TECHNICIAN
resume738_plaintext.txt	SALES REPRESENTATIVE AND COMPUTER TECHNICIAN
resume739_plaintext.txt	Program Administrator and Clerk of Course
resume740_plaintext.txt	Records Manager
resume741_plaintext.txt	Pharmacy Technician
resume742_plaintext.txt	Site Supervisor
resume743_plaintext.txt	Public Relations Intern
resume744_plaintext.txt	Assistant Public Information Officer
resume745_plaintext.txt	Sr. Application Development and Production Support Manager
resume746_plaintext.txt	NANNY/CHILDCARE/PA
resume747_plaintext.txt	Sales Consultant
resume748_plaintext.txt	Volunteer
resume749_plaintext.txt	Exhibitor/Registration Coordinator and Web Manager
resume75_plaintext.txt	Account Executive
resume750_plaintext.txt	Electrical Maintenance Manager
resume751_plaintext.txt	Teaching Associate
resume752_plaintext.txt	Tiger Pause
resume753_plaintext.txt	Senior System Engineer
resume754_plaintext.txt	PACS Administrator
resume756_plaintext.txt	District Manager
resume757_plaintext.txt	Consultant, Trainer
resume758_plaintext.txt	Team Member (volunteer)
resume759_plaintext.txt	Kinshasa, Rep Dem Congo
resume76_plaintext.txt	Pharmaceutical Sales Specialist
resume761_plaintext.txt	Fabric Buyer Associate
resume762_plaintext.txt	Product Analyst
resume763_plaintext.txt	Senior Technical Lead
resume764_plaintext.txt	Corporate Training Developer
resume765_plaintext.txt	Analyst, Accountant, HR Manager
resume766_plaintext.txt	HR Senior Generalist
resume77_plaintext.txt	Assistant
resume772_plaintext.txt	Systems Administrator II
resume773_plaintext.txt	Intake Coordinator
resume774_plaintext.txt	Administrative Assistant
resume775_plaintext.txt	Customer Service Representative/Receptionist
resume776_plaintext.txt	IT Development Manager
resume777_plaintext.txt	Visual Communications Designer
resume778_plaintext.txt	Novo Nordisk - Payroll Analyst
resume779_plaintext.txt	Programmer
resume78_plaintext.txt	Client Care Manager
resume780_plaintext.txt	Senior Director
resume781_plaintext.txt	Warehouse Supervisor/Lean Champion
resume782_plaintext.txt	Planning Engineer
resume783_plaintext.txt	Manager/Cleaner/Budget Control/School/etc
resume784_plaintext.txt	PC Technician
resume785_plaintext.txt	Instructor
resume786_plaintext.txt	Cashier
resume787_plaintext.txt	Senior Security Engineer/Architect Consultant
resume789_plaintext.txt	Clinic Secretary
resume79_plaintext.txt	Role
Developer / Consultant
resume791_plaintext.txt	Security Systems                                                       Sales Coordinator
resume793_plaintext.txt	Tradesman
resume794_plaintext.txt	Transportation Security Administration (TSA) S.T.I.P. Help Desk Specialist
resume795_plaintext.txt	CAREER PROGRESSION
resume796_plaintext.txt	Consultant
resume797_plaintext.txt	Peri
resume799_plaintext.txt	Technical Support Technician
resume8_plaintext.txt	Software Engineer
resume800_plaintext.txt	MEDICAL PRACTICE CONSULTANT
resume801_plaintext.txt	Technical Writer
resume802_plaintext.txt	Senior Program Lead
resume803_plaintext.txt	QA Senior Analyst
resume804_plaintext.txt	Customer Support Consultant
resume805_plaintext.txt	Senior Graphic Designer/ Pad Printer
resume807_plaintext.txt	Senior AV Field Engineer/Site Lead
resume808_plaintext.txt	Information Technology Support Specialist
resume809_plaintext.txt	Operations Supervisor / Alternate FSO
resume81_plaintext.txt	Traveling Ultrasound Technologist                Resources on Call Cross
resume810_plaintext.txt	Research Associate
resume811_plaintext.txt	Co-Founder and CEO
resume812_plaintext.txt	Senior Auditor
resume813_plaintext.txt	Member of Technical Staff
resume814_plaintext.txt	Senior Software Engineer
resume815_plaintext.txt	Senior Software Engineer
resume816_plaintext.txt	Senior Software Engineer
resume817_plaintext.txt	Graduate Research Assistant
resume818_plaintext.txt	Enterprise Support Technician
resume819_plaintext.txt	Career Services Coordinator
resume82_plaintext.txt	Fiduciary Clerk
resume820_plaintext.txt	General Manager
resume821_plaintext.txt	Professional Photographer
resume822_plaintext.txt	Graphic Artist
resume823_plaintext.txt	Technical Project Manager
resume825_plaintext.txt	MASTER DATA MANAGEMENT AREA SPECIALIST
resume826_plaintext.txt	Vice President
resume827_plaintext.txt	Call Centre Agent
resume829_plaintext.txt	Program Manager
resume83_plaintext.txt	HUMAN RESOURCES CONSULTANT
resume831_plaintext.txt	Clinical Trial Administrator/In-house Clinical Research Associate
resume832_plaintext.txt	Assistant Manager
resume833_plaintext.txt	IT Analyst
resume835_plaintext.txt	Network Engineer
resume836_plaintext.txt	manager
resume837_plaintext.txt	Vice President Marketing
resume838_plaintext.txt	Contractor
resume839_plaintext.txt	IT Support Project Manager
resume84_plaintext.txt	Kitchen Manager
resume840_plaintext.txt	Software Configuration Manager/Release Manager
resume841_plaintext.txt	President - Consultant
resume842_plaintext.txt	Web Designer/Photographer
resume843_plaintext.txt	Lead Business Analyst
resume845_plaintext.txt	Senior Administrator of Nanotech Startup
resume846_plaintext.txt	Proposal Manager
resume848_plaintext.txt	Project Management
resume85_plaintext.txt	Assistant Vice President
resume850_plaintext.txt	Corporate Sales Solutions Consultant
resume851_plaintext.txt	Concessionaire ? Cashier
resume854_plaintext.txt	Graduate Research Assistant
resume855_plaintext.txt	Executive Sous Chef
resume856_plaintext.txt	Solution Sales Manager
resume857_plaintext.txt	Hospital Corpsman
resume858_plaintext.txt	Inclusion Assistant
resume859_plaintext.txt	Finance Director
resume86_plaintext.txt	Essar Minerals
Tax Manager
resume860_plaintext.txt	Consultant
resume861_plaintext.txt	Classroom Assistant/PC Tech Assistant
resume862_plaintext.txt	Business Recovery Manager
resume863_plaintext.txt	Director of Operations
resume864_plaintext.txt	Web Developer II
resume865_plaintext.txt	Graphic Designer
resume866_plaintext.txt	LABORATORY TECHNICIAN
resume867_plaintext.txt	Production/ Product Development Manager
resume868_plaintext.txt	IT Analyst
resume869_plaintext.txt	Office Manager/Teaching Assistant
resume87_plaintext.txt	Contributing Scientist/Study Director/Investigator
resume871_plaintext.txt	QA Tester
resume872_plaintext.txt	Principal / Creative Director
resume873_plaintext.txt	Creative Director | Senior Graphic Designer
resume875_plaintext.txt	Consultant
resume877_plaintext.txt	Workplace Solutions Developer
resume878_plaintext.txt	Senior Buyer
resume879_plaintext.txt	Executive Protection Specialist
resume88_plaintext.txt	SYNERGY HOMECARE
resume880_plaintext.txt	Accounting Intern
resume881_plaintext.txt	Research trainee
resume882_plaintext.txt	Graduate Research Assistant
resume883_plaintext.txt	Intake Specialist
resume884_plaintext.txt	Radiologic Technologist
resume885_plaintext.txt	Supervisor and Employee Trainer
resume886_plaintext.txt	Network Engineer
resume887_plaintext.txt	Art Director / Graphic Design Contractor / Marketing Consultant
resume888_plaintext.txt	Research Specialist II
resume889_plaintext.txt	Accounting Manager
resume89_plaintext.txt	Oracle Developer / Systems Administrator / Consultant
resume890_plaintext.txt	Senior Product Manager
resume891_plaintext.txt	Intern
resume892_plaintext.txt	Manager
resume895_plaintext.txt	VOLUNTEER
resume897_plaintext.txt	Night Office Manager
resume898_plaintext.txt	Sr. Professional/Tech Design Lead
resume9_plaintext.txt	Member of Technical Staff
resume90_plaintext.txt	Sales & Marketing Representative
resume900_plaintext.txt	Manager
resume901_plaintext.txt	Sr. Linux / BSD Systems Administrator
resume902_plaintext.txt	Sr. Product Analyst
resume903_plaintext.txt	Project Management Intern
resume905_plaintext.txt	Web Designer
resume906_plaintext.txt	project manager
resume907_plaintext.txt	Owner
resume908_plaintext.txt	Information Systems Technician/System Administrator
resume909_plaintext.txt	Software and Hardware Application Support Specialist
resume91_plaintext.txt	Security Officer
resume910_plaintext.txt	SAP eSOURCING COORDINATOR
resume911_plaintext.txt	Maintenance Specialist
resume912_plaintext.txt	Claims Representative
resume913_plaintext.txt	Production Manager
resume914_plaintext.txt	Sales Representative
resume915_plaintext.txt	Financial Assistant
resume916_plaintext.txt	Director
resume917_plaintext.txt	Maintenance Technician
resume918_plaintext.txt	Vice President
resume919_plaintext.txt	Vice President
resume92_plaintext.txt	Programme Office Manager
resume920_plaintext.txt	Technical Leader
resume921_plaintext.txt	Account Manager
resume924_plaintext.txt	Digital Sales Manager
resume925_plaintext.txt	Partner
resume926_plaintext.txt	Practice Administrator
resume927_plaintext.txt	Quality Assurance Lead
resume928_plaintext.txt	Accountant
resume929_plaintext.txt	Executive Dashboard Team Lead
resume93_plaintext.txt	Fleet Vehicle Manager
resume930_plaintext.txt	VP
resume933_plaintext.txt	Senior Software Engineer
resume934_plaintext.txt	Receptionist / Administrative Assistant
resume936_plaintext.txt	Project Production Manager
resume937_plaintext.txt	Franchisee
resume939_plaintext.txt	CONSULTANT
resume940_plaintext.txt	Director
resume941_plaintext.txt	Office Administrator
resume942_plaintext.txt	Legal and Compliance Officer
resume943_plaintext.txt	Office Assistant
resume944_plaintext.txt	Senior Database Consultant
resume945_plaintext.txt	Office Assistant
resume946_plaintext.txt	Furniture Designer
resume948_plaintext.txt	Project Lead\Architect\Senior Developer
resume95_plaintext.txt	Lead Software Engineer
resume950_plaintext.txt	Program Manager
resume951_plaintext.txt	Lead QA Engineer
resume952_plaintext.txt	Internet Researcher and Writer
resume953_plaintext.txt	Public Relations Intern
resume954_plaintext.txt	Shift Manager
resume955_plaintext.txt	Product Marketing Intern
resume957_plaintext.txt	Senior Thermal Mechanical Engineer and Project Manager
resume958_plaintext.txt	Manager
resume959_plaintext.txt	Systems QA Analyst
resume96_plaintext.txt	LifeStream
resume960_plaintext.txt	Associate Producer
Lighting Director
resume961_plaintext.txt	Corporate Vice President
resume962_plaintext.txt	Academic Tutor
resume963_plaintext.txt	Freelancer
resume964_plaintext.txt	Installer/Welder
resume967_plaintext.txt	Senior QA Engineer
resume968_plaintext.txt	Business Development Manager
resume969_plaintext.txt	Training Specialist II
resume97_plaintext.txt	Sales and Design Studio Representative
resume970_plaintext.txt	Teaching Assistant
resume971_plaintext.txt	Malaria Technical Advisor
resume972_plaintext.txt	Senior Project Administrator
resume973_plaintext.txt	Procurement Manager/Specialist
resume974_plaintext.txt	Property
Manager
resume975_plaintext.txt	Intern Show Runner/ Audio Editor
resume976_plaintext.txt	Director
resume977_plaintext.txt	Consultant
resume978_plaintext.txt	Contractor
resume979_plaintext.txt	Logistics Management Analyst
resume98_plaintext.txt	Merchandise Associate
resume980_plaintext.txt	President & Owner
resume981_plaintext.txt	Business Systems Administrator/Marketing
resume982_plaintext.txt	Manager
resume983_plaintext.txt	Certified Pediatric Technician
resume984_plaintext.txt	Volunteer
resume985_plaintext.txt	Senior Specialist
resume986_plaintext.txt	Assistant Head-Teller
resume987_plaintext.txt	PMO Consultant
resume988_plaintext.txt	BUSINESS DEVELOPMENT SPECIALIST FINISHED BEEF
resume989_plaintext.txt	Administrative Assistant/Receptionist
resume99_plaintext.txt	Business Development Manager
resume990_plaintext.txt	Manager/Customer Service Rep
resume991_plaintext.txt	HP / Consultant
resume992_plaintext.txt	Client Services Manager
resume993_plaintext.txt	Executive Assistant | Contractor
resume994_plaintext.txt	Web Developer
resume995_plaintext.txt	Senior Marketing Consultant
resume996_plaintext.txt	Consultant
resume998_plaintext.txt	Accountant
resume999_plaintext.txt	Director
